############################################################################
#..........................................................................#
#..........................................................................#
#..........................................................................#
#..........................................................................#
#..........................................................................#
#..........................................................................#
#..........................................................................#
#..........................................................................#
#..........................................................................#
#..........................................................................#
#..........................................................................#
#..........................................................................#
#..........................................................................#
#..........................................................................#
#..........................................................................#
#..........................................................................#
#................#######...................................................#
#.................................................#####....................#
#........@.................................................................#
#.....########.........#...................................................#
#......................#...................................................#
############################################################################
