############################################################################
#..........................................................................#
#..........................................................................#
#..........................................................................#
#..........................................................................#
#..........................................................................#
#..........................................................................#
#..........................................................................#
#..........................................................................#
#...................................##########.............................#
#...................................#.........#............................#
#.................................##...........#...........................#
#..........................................................................#
#..........................................................................#
#..........................................................................#
#..........................................................................#
#..........................................................................#
#................#######...................................................#
#.................................................#####....................#
#........@.............................................#...................#
#.....########.........#................................#..................#
#......................#.................................#.................#
############################################################################
