###############################
#.............................#
#.............................#
#.............................#
#................#######......#
#.............................#
#........@....................#
#.....########.........#......#
#......................#......#
###############################
